11 11
XXXXXXXXXT.
XX...XX....
X....G..S..
XX.........
....XG.....
XX..XGX....
....XXX....
XX...XX.K..
..G........
XX...XX....
...........
