11 11
XXXXXXXXXKT
XX...XX....
X....G..S..
XX.........
....XG.....
XX..XGX....
....XXX....
XX...XX....
..G........
XX...XX....
...........
