11 11
XXXXXXXXXKT
XX...XX....
X....G..S..
XX.........
....XG...K.
XX..XGX....
....XXX....
XX...XX....
..G..K.....
XX...XX....
...........
