11 11
XXXXXXXXXKT
XX...XX....
X....G..S..
XX.........
....XG.....
XX..XGX.K..
....XXX....
XX...XX....
..GK.......
XX...XX....
...........
