15 15
T.........S....
.XX.....XX.....
.....G.........
.....G.........
.X...G...X.....
.X.......X.....
..XXX.XXX......
.....K.........
..G..K.........
.....K.........
...............
...............
...............
...............
...............