11 11
XXXXXXXXX.T
XX...XX....
X....G..S..
XX.........
....XG.....
XX..XGX....
....XXX....
XX...XX....
..G........
XX...XX....
...........
