15 15
T.............G
.XXX.......XXX.
.....X.........
.....X.........
.X...X.......X.
.X...........X.
..XXXXXXXXXXX..
...............
...............
...............
XXXXXXXXXXXXX.X
...............
.XXXXXXXXXXXXX.
...............
XXXXXX..S..XXXX