15 15
T.........S....
.XXX.......XXX.
.....X.........
.....X.........
.X...X.......X.
.X...........X.
..XXXXXXXXXXX..
...............
..G............
.XX.........X..
XXXXXXXXXXXXX.X
...............
.XXXXXXXXXXXXXX
...............
XXXXXX.....XXXX